Mm, Mm, Mm, Hh, Hh, Gg, Gg, Gg, Gg, Gg, Gg, Gg, Hh^Fms, Gg, Gg^Fms, Gg, Gg, Gg, Gg, Gg, Gg, Gg, Gg, Gg, Gg, Gg, Gg^Fms, Gg, Gg, Gg, Gg^Fms, Gg, Gg, Gg, Gg^Fms, Gg, Gg^Fms, Gg^Fms, Gs^Fms, Gs^Fms, Gg^Efm, Gs^Fms
Mm, Mm, Mm^Fms, Mm, Mm, Hh, Hh, Hh, Hh^Fms, Hh, Hh^Fms, Hh^Fms, Hh, Gg^Fms, Ww, Gg, Gg^Fds, Gg^Fms, Gs^Fds, Gg^Fms, Gg^Fms, Gg, Gg^Fms, Gg, Gg, Gg^Fms, Gg^Fds, Gs^Fms, Gs^Fds, Gg^Fms, Gg^Fms, Gg^Fms, Gg^Fp, Gg^Efm, Gg^Fp, Gg^Fms, Cv^Fms, Gs^Fms, 1 Kv^Fp, Gs^Fms, Gg^Efm, Gg
Ww, Mm, Mm^Fds, Mm^Fms, Mm, Hh^Fms, Hh^Fms, Gs^Fms, Hh, Gs^Fms, Hh, Hh^Fms, Hh^Fms, Ww, Ww, Ww^Ewf, Ww, Gg^Fms, Gg^Fds, Gg^Fms, Gg^Efm, Gg^Efm, Gg^Fms, Gg^Fms, Gg^Fms, Gg^Fms, Gg^Fms, Gs^Fms, Gg^Fms, Gg^Fms, Gg^Fms, Gg^Fms, Gg^Fms, Gs^Fms, Gg^Fms, Gg^Ve, Cv^Fms, Cv^Fp, Cv^Fp, Gg^Fet, Gg^Fms, Gg^Fms
Ww, Ww, Ww, Ww^Ewl, Ww^Ewf, Mm^Fms, Hh^Fms, Hh^Fms, Wwf^Ewl, Hh^Fms, Ww, Ww, Ww, Ww, Ww, Ww^Ewf, Ww, Ww, Ww, Gg^Fms, Gg^Fms, Gg^Fms, Gg^Fp, Gg^Fms, Gg^Fms, Gg^Fms, Gg^Fms, Gg^Fds, Gg^Fms, Gg^Fp, Gg^Fms, Gg^Fms, Cv^Fms, Gg, Gg^Fms, Gg^Fms, Gg^Fms, Cv^Fp, Cv^Fp, Gg^Ve, Gg^Fms, Gg^Fms
Ww, Ww, Ww, Ww, Ww, Ww, Wwf, Wwf, Ww, Ww, Ww, Ww, Ww, Ww, Ww, Ww^Ewl, Ww, Ww, Gs^Fp, Ww, Gg^Fds, Gg^Fms, Gg^Fms, Gg^Fms, Gg^Fp, Gg^Fp, Gg, Gg^Fms, Gg^Fms, Gg^Fms, Gg^Fms, Gg^Fms, Gg^Fms, Gg^Fms, Gg^Fms, Gg^Fp, Gg^Fms, Gg^Fms, Gg^Fms, Gg^Fms, Gs^Fds, Gg^Fms
Mm, Mm, Mm^Fms, Mm, Mm, Ww, Wwf, Wwf, Hh^Fms, Ww, Gs^Fms, Gs^Fds, Gs^Fms, Gg^Efm, Gs^Fms, Gs^Fms, Gg, Gs^Fp, Gg^Fp, Wwf, Wwf, Gg^Fms, Ww, Gg^Fms, Gg, Gg, Gg, Gg, Gg, Gs^Fms, Gg^Efm, Gg^Ve, Gg^Fms, Gg^Fms, Gg^Fms, Gs^Fms, Cv^Fp, Gg^Fms, Gg^Fp, Gg^Fms, Gg^Fms, Gg
Mm, Mm^Fms, Mm, Mm, Mm^Fms, Hh, Hh, Hh^Fds, Hh, Hh^Fds, Hh^Efm, Gs^Fms, Gg^Efm, Gs^Fms, Gs^Fms, Gs^Fms, Gg, Gg, Gg, Gg^Fp, Gg^Fp, Wwf, Ww, Ww, Ww, Gg, Gg, Gg, Gg, Gg^Efm, Gg, Gg, Wwf, Gg, Ww, Gg^Efm, Gg, Gg^Fms, Gg^Fp, Gg^Fds, Gg^Fms, Gg^Fp
Mm, Mm, Mm^Fms, Mm^Fms, Mm^Fms, Mm, Mm, Mm, Mm, Hh, Hh, Hh^Fms, Hh^Fms, Hh^Fms, Hh^Fms, Gg, Gs^Fms, Gg^Fms, Gg^Fms, Gg^Fms, Gg^Efm, Gg^Fms, Gg, Ww, Ww, Ww^Ewf, Ww, Gg, Ww, Gs^Fms, Wwf, Wwf, Wwf, Ww^Ewl, Ww, Ww, Wwf, Gg^Fms, Gg^Fms, Gg^Fms, Gg, Gg^Fms
Mm, Mm, Mm^Fms, Mm, Hh^Fms, Hh, Hh^Fp, Mm^Fms, Mm, Mm, Hh^Fds, Gs^Fms, Hh, Hh^Efm, Hh, Hh, Hh^Fms, Gs^Fms, Gs^Fds, Gg^Fms, Gg^Fp, Gg^Fms, Gg, Gg, Gg, Ww, Ww, Ww, Ww, Ww, Ww^Ewl, Wwf^Ewf, Gs^Fms, Gs^Fms, Gs^Fms, Wwf, Wwf, Gg, Gg^Fms, Gg^Fms, Gg^Fds, Gg^Fms
Mm, Mm^Fms, Mm, Hh, Gg^Fet, Gd^Fms, Gd^Fms, Hh, Mm^Fms, Mm, Hh^Fms, Hh^Fds, Hh, Hh, Hh, Hh^Fms, Hh^Fms, Gs^Fds, Gs^Vh, Gs^Fms, Gs, Gg, Gs^Fms, Gg, Gg, Gg, Gg, Ww, Gg, Ww, Ww, Ww^Ewl, Gs^Fms, Gs^Fms, Gs^Fms, Gs^Fms, Ww^Ewl, Wwf, Ww, Gg^Fms, Gg^Fms, Gg
Mm, Mm, Mm, Hh, Gll^Fmf, Gs^Fmf, Gd^Vh, Hh^Fms, Hh^Fms, Mm^Fms, Mm^Fms, Hh, Hh, Hh, Hh^Fms, Hh^Fms, Gs^Fms, Gs^Fms, Gg, Gs, Gs, Gs^Fds, Gs, Gg, Gg, Gg, Gg, Gg, Gg, Gg, Ww, Ww^Ewf, Gs^Fms, Gg^Fet, Gs^Fms, Gs^Fms, Ww, Ww, Ww, Gg^Efm, Ww, Gg^Fms
Mm, Mm, Mm, Hh, Gs, Gll^Fmf, Gd^Fms, Hh^Fms, Hh, Hh, Hh^Fms, Hh^Fp, Gg^Fp, Hh^Fp, Hh^Fms, Hh^Fmw, Gg, Gg, Gg, Gg, Gll^Fmf, Gll^Fmf, Gg, Gg, Gg, Gg, Gg, Gg, Gll^Fmf, Gg, Gs^Fms, Ww, Wwf, Gs^Fms, Ww, Ww, Ww^Ewf, Ww^Ewf, Gs^Fms, Wwf, Ww, Ww^Ewl
Mm, Mm, Gs^Vh, Hh, Gll^Fmf, Gll^Fmf, Gg, Gs, Gg, Gg, Gg, Gg, Gg, Gg, Gg, Gg, Gg, Gg, Gs, Gs, Gll^Fmf, Gs, Gs, Gs, Gs, Gg, Gll^Fmf, Gll^Fmf, Gll^Fmf, Gs^Fms, Gg, Wwf, Wwf, Wwf, Ww, Ww, Ww, Ww, Gs^Fds, Ww, Ww, Ww^Ewl
Gg, Gg, Gs, Gs, Gs, Gll^Fmf, Gd, Gs, Gs, Gs, Gs, Gs, Gs, Gs, Gs, Gs, Gs, Gs, Gll, Gs, Gll^Fdw, Gll^Fdf, Gd, Gs, Gd, Gs, Gll^Fmf, Gll^Fmf, Gd, Gg, Gg, Gg^Efm, Gg^Fms, Ww, Ww, Ww, Ww^Ewl, Gg, Gs^Fds, Ww, Ww, Ww
Gg, Gg, Gs, Gs, Gll^Fmf, Gll^Fmf, Gll^Fmf, Gd, Gd, Gs, Gll, Gd, Gll^Fdf, Gll, Gll, Gs, Gll, Gd, Gll^Fdw, Gs, Gd, Gd, Gd, Gd, Gs, Gll^Fmf, Gll^Fdf, Gll^Fdf, Gd, Gs, Gs^Fms, Gg, Gg^Fms, Gg^Fds, Ww, Ww^Ewf, Gg, Gg^Fp, Gs^Fms, Gs^Fms, Ww, Ww
Gs, Gs, Gs, Gs, Gd, Gs^Fdw, Gd, Gll^Fdf, Gll^Fdf, Gll, Gll, Gll^Fdf, Gll^Fdf, Gll, Gll, Gll, Gll^Fdw, Gll^Fdw, Gll, Gll^Fdw, Gll, Gll, Gll^Fdf, Gll^Fdf, Gd, Gd, Gs, Gd, Gs, Gs, Gg, Gg, Gg, Gs^Fms, Wwf, Wwf^Ewf, Ww^Ewl, Gs^Fms, Ww^Ewf, Gg^Ve, Ww, Ww
Gs, Gs, Gs, Gd, Gll^Fdf, Gd, Gll, Gll, Gll^Fdf, Gll, Gll, Gll^Fdw, Gll, Gll^Fdf, Rb, Gll, Rb, Gll, Rb, Rb, Gll, Gll^Fdw, Gll^Fdw, Gll^Fdf, Gll^Fdf, Gd, Gd, Gd, Gs, Gs, Gs, Gs, Gs, Gg, Gg, Wwf, Ww, Ww, Ww, Ww, Ww^Ewl, Ww
Gs, Gs, Gd, Gll^Fdf, Gd, Gll, Gll^Fdw, Gll^Fdw, Gll^Fdw, Gll^Fdw, Gll, Gll, Gd, Gll^Fdf, Rb, Rb, Rb, Cer, Cer, Gll, Rb, Gll^Feth, Gll^Fdw, Gll^Fdf, Gll, Gd, Gd, Gd, Gd, Gd, Gd, Gs, Gs^Fmf, Gs, Gs^Fmf, Gg, Gg, Ww, Ww, Ww, Ww, Gs^Fms
Gs, Gs, Gd, Gll^Fdf, Gll, Gll, Gll, Gll^Fdw, Gll, Gll, Rb, Rb, Rb, Rb, Rb, Rb, Rb, Cer, Cer, Cer, Rb, Rb^Vhhr, Gll, Gll^Fdf, Gll^Fdw, Gll^Fdw, Gll^Fdw, Gll, Gll, Gd^Fdw, Gll^Fdf, Gd, Gs^Fmf, Gs^Fmf, Gs, Gg, Gg, Gg, Gg, Ww, Gg, Gs^Fms
Gll, Gd, Gll, Gd, Gll, Gll, Gd, Gll, Gll, Gll, Rb, Rb, Rb, Gll^Fdw, Gd, Rb, Rb, 2 Ker, Rb, Rb, Rb, Gll, Rb, Gll, Gll, Gll^Fdw, Gll, Gll^Fdw, Gll, Gll, Gll^Fdf, Gll^Fdf, Gd^Fdw, Gs, Gs, Gs, Gs, Gg, Gg, Gg, Gg, Gg
Gll, Gll, Gll^Fdw, Gd, Gll, Gll, Gll, Gll, Gll, Rb, Rb, Gll^Fdw, Rb, Gll, Rb, Rb, Rb, Rb, Rb, Rb, Gll, Rb, Rb, Rb, Rb, Gll, Gll, Gll, Gll, Gll, Gll, Gll^Fdf, Gll, Gll^Fdw, Gd, Gs, Gs, Gs, Gg, Gg, Gg, Ww^Ewl
Gg, Gll, Gd, Gll, Gd, Gll^Fdw, Gd, Gll, Gd, Rb, Rb, Rb, Rb, Rb, Rb, Rb, Rb, Rb, Rb, Rb, Rb, Rb, Rb, Rb, Gll, Gll, Gll, Gll, Gll, Gll, Gll, Gll, Gs, Gs, Gd, Gs, Gs, Gs, Ww, Gg, Gs^Fms, Ww
