Hh^Fms, Hh, Hh, Gg, Gg, Gg, Gs^Fms, Gg, Gs^Fms, Gg, Gg^Fms, Gg, Gg^Fms, Gg, Gg, Gg, Gg, Gg, Gg, Gg, Gg, Gg, Gg, Gs^Fms, Gs^Fms, Gg, Gg^Fms, Gg, Gg, Gg, Gg, Gg, Gg, Gg, Gg, Gg, Gg, Gg, Gg, Gg, Gg, Gg, Gg^Fp, Gg, Gg, Gg
Mm^Fms, Mm, Hh, Hh, Hh^Fms, Gg, Gg, Hh^Fms, Hh^Efm, Hh, Hh^Fms, Gg^Fms, Gg^Fms, Gg, Gs^Fms, Gg, Gg^Fms, Gg, Gg^Fms, Gg, Gg^Fms, Gg^Fms, Gg, Gg^Fms, Gg^Fp, Gg^Fms, Gg, Gg^Fms, Gg^Fms, Gg^Fms, Gg^Fms, Gg^Fms, Gg^Fms, Gg^Fms, Gg^Fms, Gg, Gg^Fms, Gs^Fms, Gg^Fp, Gs^Fms, Gs^Fms, Gg, Gg^Fms, Gg, Gg^Fp, Gg
Mm^Fms, Mm^Fms, Mm, Mm^Fms, Hh^Fms, Hh^Fms, Hh^Fms, Hh, Hh^Fms, Hh^Efm, Hh, Hh^Fms, Hh^Fms, Gs^Fms, Gg^Efm, Gg^Fms, Gg^Fms, Gg^Fms, Gg^Fms, Gg^Fms, Gg^Fms, Gg^Fms, Gg^Fp, Gg^Fms, Gg^Fms, Gg^Fms, Gg^Fms, Gg^Fms, Gs^Fms, Gg, Gg^Fms, Gg, Gg, Gg, Gg^Fms, Gg^Fms, Gg^Fms, Gg, Gg, Gg, Gg, Gg, Gg^Fms, Gg^Fms, Gg, Gg
Hh^Fms, Mm, Mm^Fms, Mm^Fms, Hh, Hh^Fms, Hh^Ve, Hh^Efm, Hh^Efm, Hh^Fms, Hh^Fms, Hh^Fms, Gg^Fms, Gg^Efm, Gs^Fds, Gg^Fms, Gg^Efm, Gg, Gg, Gg^Fms, Gg, Gg^Fms, Gg^Fms, Gg^Fms, Gg^Fms, Gg^Efm, Gg^Efm, Gg^Fp, Gg^Fms, Gg^Fms, Gg^Fp, Gg^Fms, Gg^Fp, Gg^Fms, Gg^Fms, Cv^Fms, Gg^Fp, Gg^Fms, Gg, Cv^Fms, Gg^Fp, Gg, Gg, Gg, Gg^Fms, Gg
Hh^Fms, Hh^Fms, Hh^Fds, Mm^Fms, Mm, Hh^Fms, Hh^Fp, Hh^Fms, Hh^Fds, Hh^Fms, Hh, Hh^Fms, Hh^Fms, Gg^Fms, Gg^Fms, Gg^Fms, Gg, Gg^Efm, Gg^Fms, Gg^Efm, Gg^Fms, Gg^Fms, Gg^Efm, Gg^Fms, Gg^Ve, Gg^Fms, Gg^Fms, Gg^Efm, Gg^Fms, Gg^Fp, Gg^Fms, Gg^Fms, Cv^Fms, Gg^Efm, Gg^Fms, Gs^Fds, Gg^Fms, Gg^Fms, Gs^Fms, Gs^Fms, Gg^Efm, Gs^Fms, Gs^Fms, Gg^Fp, Gg^Fms, Gg^Fms
Gs^Fms, Hh^Fms, Hh^Fms, Mm^Fms, Hh^Fms, Mm^Fms, Hh^Fms, Hh, Hh^Fms, Hh^Fms, Hh^Fms, Hh^Fms, Hh, Gg^Fms, Ww, Gg, Gg^Fds, Gg^Fms, Gs^Fds, Gg^Fms, Gg^Fms, Gg^Fms, Gg^Fms, Gg^Fms, Gg, Gg^Fms, Gg^Fds, Gs^Fms, Gs^Fds, Gg^Fms, Gg^Fms, Gg^Fms, Gg^Fp, Gg^Efm, Gg^Fp, Gg^Fms, Cv^Fms, Gs^Fms, 1 Kv^Fp, Gs^Fms, Gg^Efm, Gg, Cv^Fms, Gg^Fds, Gg^Fms, Gg^Fms
Ww, Gs^Fms, Gs^Fds, Gs^Fms, Gg, Hh^Fms, Gs^Fms, Gs^Fms, Gg, Gs^Fms, Gg, Gg^Fms, Gs^Fms, Ww, Ww, Ww^Ewf, Ww, Gg^Fms, Gg^Fds, Gg^Fms, Gg^Efm, Gg^Efm, Gg^Fms, Gg^Fms, Gg^Fms, Gg^Fms, Gg^Fms, Gs^Fms, Gg^Fms, Gg^Fms, Gg^Fms, Gg^Fms, Gg^Fms, Gs^Fms, Gg^Fms, Gg^Ve, Cv^Fms, Cv^Fp, Cv^Fp, Gg^Fet, Gg^Fms, Gg^Fms, Gg^Fp, Gg^Fms, Gg^Fms, Gg^Fms
Ww, Ww, Ww, Ww^Ewl, Ww^Ewf, Gs^Fms, Gs^Fms, Gs^Fms, Wwf^Ewl, Gs^Fms, Ww, Ww, Ww, Ww, Ww, Ww^Ewf, Ww, Ww, Ww, Gg^Fms, Gg^Fms, Gg^Fms, Gg^Fp, Gg^Fms, Gg^Fms, Gg^Fms, Gg^Fms, Gg^Fds, Gg^Fms, Gg^Fp, Gg^Fms, Gg^Fms, Cv^Fms, Gg, Gg^Fms, Gg^Fms, Gg^Fms, Cv^Fp, Cv^Fp, Gg^Ve, Gg^Fms, Gg^Fms, Gg^Fds, Gg^Efm, Gg^Efm, Gg
Gg, Ww, Ww, Ww, Ww, Ww, Wwf, Wwf, Ww, Ww, Ww, Ww, Ww, Ww, Ww, Ww^Ewl, Ww, Ww, Gs^Fp, Ww, Gg^Fds, Gg^Fms, Gg^Fms, Gg^Fms, Gg^Fp, Gg^Fp, Gg, Gg^Fms, Gg^Fms, Gg^Fms, Gg^Fms, Gg^Fms, Gg^Fms, Gg^Fms, Gg^Fms, Gg^Fp, Gg^Fms, Gg^Fms, Gg^Fms, Gg^Fms, Gs^Fds, Gg^Fms, Gg, Gg^Fms, Gg^Fms, Gg
Mm, Gg, Gs^Fms, Gg, Gg, Ww, Wwf, Wwf, Gs^Fms, Ww, Gs^Fms, Gs^Fds, Gs^Fms, Gg^Efm, Gs^Fms, Gs^Fms, Gg, Gs^Fp, Gg^Fp, Wwf, Wwf, Gg^Fms, Ww, Gg^Fms, Gg, Gg, Gg, Gg, Gg, Gs^Fms, Gg^Efm, Gg^Ve, Gg^Fms, Gg^Fms, Gg^Fms, Gs^Fms, Cv^Fp, Gg^Fms, Gg^Fp, Gg^Fms, Gg^Fms, Cv^Fp, Gg^Fms, Gg^Fms, Gg^Fp, Gg
Mm, Mm^Fms, Gs^Fms, Gg, Gs^Fms, Gs, Gs, Gs^Fds, Gs, Gs^Fds, Gg^Efm, Gs^Fms, Gg^Efm, Gs^Fms, Gs^Fms, Gs^Fms, Gg, Gg, Gg, Gg^Fp, Gg^Fp, Wwf, Ww, Ww, Ww, Gg, Gg, Gg, Gg, Gg^Efm, Gg, Gg, Wwf, Gg, Ww, Gg^Efm, Gg, Gg^Fms, Gg^Fp, Gg^Fds, Gg^Fms, Gg^Fp, Gg^Fms, Gg^Fms, Gg^Fms, Gg
Mm, Mm, Mm^Fms, Mm^Fms, Mm^Fms, Mm, Mm, Mm, Mm, Gs, Hh, Hh^Fms, Hh^Fms, Hh^Fms, Hh^Fms, Gg, Gs^Fms, Gg^Fms, Gg^Fms, Gg^Fms, Gg^Efm, Gg^Fms, Gg, Ww, Ww, Ww^Ewf, Ww, Gg, Ww, Gs^Fms, Wwf, Wwf, Wwf, Ww^Ewl, Ww, Ww, Wwf, Gg^Fms, Gg^Fms, Gg^Fms, Gg, Gg^Fms, Gg^Fms, Gg^Fds, Gg, Gg
Mm, Mm, Mm^Fms, Mm, Hh^Fms, Hh, Hh^Fp, Mm^Fms, Mm, Mm, Hh^Fds, Gs^Fms, Hh, Hh^Efm, Hh, Hh, Hh^Fms, Gs^Fms, Gs^Fds, Gg^Fms, Gg^Fp, Gg^Fms, Gg, Gg, Gg, Ww, Ww, Ww, Ww, Ww, Ww^Ewl, Wwf^Ewf, Gs^Fms, Gs^Fms, Gs^Fms, Wwf, Wwf, Gg, Gg^Fms, Gg^Fms, Gg^Fds, Gg^Fms, Gg^Fms, Gg^Fms, Gg^Ve, Gs^Fms
Mm^Fms, Mm^Fms, Mm, Hh, Gg^Fet, Gd^Fms, Gd^Fms, Hh, Mm^Fms, Mm, Hh^Fms, Hh^Fds, Hh, Hh, Hh, Hh^Fms, Hh^Fms, Gs^Fds, Gs^Vh, Gs^Fms, Gs, Gg, Gs^Fms, Gg, Gg, Gg, Gg, Ww, Gg, Ww, Ww, Ww^Ewl, Gs^Fms, Gs^Fms, Gs^Fms, Gs^Fms, Ww^Ewl, Wwf, Ww, Gg^Fms, Gg^Fms, Gg^Fms, Gg, Gg^Fp, Gg^Fms, Gs^Fms
Mm, Mm, Mm, Hh, Gll^Fmf, Gs^Fmf, Gd^Vh, Hh^Fms, Hh^Fms, Mm^Fms, Mm^Fms, Hh, Hh, Hh, Hh^Fms, Hh^Fms, Gs^Fms, Gs^Fms, Gg, Gs, Gs^Fms, Gs^Fds, Gs, Gg, Gg, Gg, Gg, Gg, Gg, Gg, Ww, Ww^Ewf, Gs^Fms, Gg^Fet, Gs^Fms, Gs^Fms, Ww, Ww, Ww, Gg^Efm, Ww, Gg^Fms, Gg^Fms, Gg^Fms, Gg, Gg
Gg, Mm, Mm, Hh, Gs, Gll^Fmf, Gd^Fms, Hh^Fms, Hh, Hh, Hh^Fms, Hh^Fp, Gg^Fp, Hh^Fp, Hh^Fms, Hh^Fmw, Gg, Gd^Fmf, Gd^Fmf, Gs^Fms, Gs^Fms, Gs, Gs^Fp, Gs, Gg, Gg, Gg, Gg, Gs^Fms, Gg, Gs^Fms, Ww, Wwf, Gs^Fms, Ww, Ww, Ww^Ewf, Ww^Ewf, Gs^Fms, Wwf, Ww, Ww^Ewl, Gg, Gg, Gg, Gg
Gg, Mm, Gs^Vh, Hh, Gll^Fmf, Gd^Fmf, Gs, Gg, Gs, Gg, Gs^Fms, Gs^Fms, Gs, Hh^Fp, Hh^Fms, Gg^Fmw, Gd^Fmf, Gd^Fmf, Gd^Fmf, Gs, Gs, Gs^Fms, Gs^Fmw, Gd^Fmf, Gg, Gg, Gg^Fp, Gs^Fms, Gs^Fms, Gs^Fms, Gg, Wwf, Wwf, Wwf, Ww, Ww, Ww, Ww, Gs^Fds, Ww, Ww, Ww^Ewl, Gg, Gg, Gg, Gg
Gg, Gg, Gll^Fmf, Gs, Gd^Fmf, Gd^Fmf, Gs, Gs, Gs, Gg, Gg, Gs^Fms, Gs, Hh, Hh^Fmf, Gd^Fmf, Gd^Fmf, Gg^Fmw, Gg, Gd^Fmf, Gg, Gs^Fms, Gd^Fmf, Gd^Fmf, Gg, Gg, Gs^Fms, Gs^Vh, Gg, Gg, Gg, Gg^Efm, Gg^Fms, Ww, Ww, Ww, Ww^Ewl, Gg, Gs^Fds, Ww, Ww, Ww, Gs^Fms, Gs^Fms, Gg, Gg
Gg, Gs, Gll^Fmf, Gd^Fmf, Gll^Fmf, Gs, Gs, Gs, Gll^Fmf, Gll^Fmf, Gd^Fmw, Gd^Fmf, Gd^Fmf, Gd^Fmf, Gs, Gs^Fmw, Gg, Gg, Gg^Fms, Gg, Gg^Fp, Gg, Gd^Fmf, Gg, Gs^Fds, Gs^Fms, Gs^Fms, Gs^Fds, Gs^Fms, Gg, Gs^Fms, Gg, Gg^Fms, Gg^Fds, Ww, Ww^Ewf, Gg, Gg^Fp, Gs^Fms, Gs^Fms, Ww, Ww, Gg, Gs^Fms, Gg, Gg
Gg, Gll^Fdf, Gll^Fdf, Gs, Gg, Gll^Fmf, Gs, Gs, Gll^Fdf, Gll^Fdf, Gs^Fmw, Gd^Fmf, Gs, Gs, Gs, Gs, Gs^Fms, Gg^Fms, Gg^Fms, Gg^Fms, Gg^Fp, Gg, Gd^Fmf, Gg^Fmw, Gs^Fms, Gg, Gs^Fms, Gs^Fms, Gs^Fms, Gs^Fms, Gs^Fds, Gg, Gg, Gs^Fms, Wwf, Wwf^Ewf, Ww^Ewl, Gs^Fms, Ww^Ewf, Gg^Ve, Ww, Ww, Ww^Ewl, Ww, Ww, Ww
Gg, Gll^Fdw, Gll^Fdw, Gs, Gll^Fdf, Gll^Fdf, Gs, Gs, Gg^Fmw, Gll^Fdf, Gg, Gg, Gll, Gg, Gll^Fmf, Gs, Gs^Fmw, Gg, Gs, Gg, Gg, Gg^Fmw, Gd^Fmf, Gs^Fms, Gg, Gs^Fms, Gs^Fms, Gs^Fms, Gs^Fms, Gg, Gg, Gg, Gs^Fms, Gg, Wwf, Wwf, Ww, Ww, Ww, Ww, Ww^Ewl, Ww, Ww, Ww, Ww, Ww
Gll, Gll, Gll, Gg, Gll, Gg, Gd, Gll^Fdf, Gd^Vhr, Gll^Fdf, Gll^Fdf, Gd, Gd, Gll^Fmw, Gll^Fmf, Gll^Fmf, Gll^Fmf, Gll, Gd^Fmf, Gd^Fmw, Gd^Fmf, Gd^Fmf, Gd^Fmf, Gs^Fms, Gg, Gs^Fds, Gg, Gs^Fds, Gs^Fms, Gs^Vh, Gg, Gg, Gs^Fms, Gg, Gg, Gg, Gs^Fms, Ww, Gs^Fms, Ww, Gg, Gs^Fms, Gs^Fms, Ww, Gg, Gg
Gll^Fdw, Gll, Gll^Fdw, Gll, Gll, Gll^Fdw, Gll^Fdw, Gll, Gll, Gll, Gd, Gd, Gd^Fdw, Gll^Fdw, Gll, Gll^Fmf, Gd, Gll^Fmf, Gs, Gs, Gg, Gg, Gg, Gd^Fmf, Gs, Gg, Gs, Gg^Fp, Gs^Fms, Gs^Fms, Gs^Fms, Gg, Gg, Gs^Fms, Hh, Hh, Hh^Fms, Gs^Fms, Gs^Fms, Gg, Gs^Fms, Gg, Gg, Gg, Gg, Gg
Gll, Gll^Fdw, Rb, Gd^Fdw, Gll, Gll, Gll^Fdw, Gll, Gd, Gll, Gll, Gll^Fdf, Gll^Fdf, Gll, Gll^Fdf, Gll^Fdf, Gll^Fdf, Gll^Fmf, Gs, Gs, Gs, Gg, Gs, Gs, Gs, Gs, Gg, Gs, Gs, Gs, Gs, Gg, Gs^Fms, Hh, Hh, Hh, Hh, Hh^Fms, Hh^Fms, Gs^Fds, Gs^Fms, Gg, Gs^Fms, Gg, Gg, Gg
Gll, Rb, Rb, Rb, Rb, Gll, Gll^Fdw, Gd, Gll, Gll, Gll, Gll, Gd, Gll, Gd, Gll^Fdf, Gll^Fdw, Gll^Fdf, Gll^Fdw, Gs, Gll^Fmf, Gs^Fmw, Gll^Fmf, Gs, Gs, Gs, Gs, Gll^Fmf, Gs^Fms, Gs, Gs^Fms, Gs^Fms, Gg, Hh^Fms, Hh^Fms, Hh, Hh, Hh, Hh, Gs^Fms, Gg, Gs^Vh, Gg, Gs^Fms, Gs^Fms, Gg
Gll, Rb, Rb, Rb, Rb, Rb, Rb, Gll^Fdw, Gll, Gll^Fdw, Gll^Fdw, Gll, Gll^Fdw, Gll, Gll, Gll, Gll, Gll^Fdf, Gs, Gg, Gll^Fmf, Gll^Fmf, Gll^Fmf, Gll^Fmf, Gs, Gg, Gll^Fmf, Gll^Fmf, Gg, Gs^Fms, Gs, Gs^Fms, Gs, Gs^Fms, Gs^Fms, Hh, Hh, Hh, Hh, Hh, Gg, Gg, Gg, Gg, Gg, Gg
Rb, Rb, Gll, Gd^Fetd, Rb, Rb, Rb, Gll, Gll, Gll, Gd, Gd^Fdw, Gll, Gll^Fdw, Gll^Fdf, Gll^Fdf, Gll^Fdf, Gll^Fdf, Gll^Fdf, Gs, Gs, Gs^Vhhr, Gll^Fmf, Gll^Fmf, Gs^Fmw, Gs, Gll^Fmf, Gs, Gs, Gg, Gs, Gg, Gs, Gs, Gll^Fmf, Gs^Fms, Gs^Fms, Hh, Hh, Hh, Gg, Gg, Gs^Fms, Gg, Gs, Gg
Rb, Rb, Rb, Rb, Rb, Gll, Gll^Fdw, Rb, Rb, Gll^Fdw, Gll^Fdw, Gd, Gd, Gll^Fdw, Gll^Fdw, Gll, Gll, Gll, Gd, Gs, Gs, Gd, Gg, Gll^Fmf, Gll^Fmf, Gll^Fmf, Gll^Fmf, Gll^Fmf, Gs^Fmw, Gs, Gs, Gs, Gll^Fmf, Gll^Fmf, Gg, Gg, Hh, Hh^Fms, Hh^Fms, Hh, Gg, Gs^Fms, Gs^Fms, Gs^Fms, Gs^Fms, Gg
Rb, Rb, Rb, Rb, Rb, Gll, Rb, Rb, Gd^Vhr, Gd, Gll^Fdw, Gll, Gll, Gll, Gll, Gll, Gll^Fdw, Gll, Gll, Gll^Fdf, Gd, Gd, Gll^Fdf, Gll^Fmf, Gd^Fdw, Gs, Gs, Gll^Fmf, Gll^Fmf, Gs, Gs, Gg, Gs^Fmw, Gll^Fmf, Gg, Gg, Hh, Hh, Hh^Fms, Hh, Gs^Fms, Gs^Fms, Gs^Fms, Gg, Gs^Fms, Gg
Rb, Rb, Gll, Gll, Gll, Rb, Rb, Rb, Rb, Gll^Fdw, Gll, Rb, Rb, Gll, Gd, Gll, Gll^Fdw, Gll^Fdw, Gll, Gll^Fdf, Gd^Vhr, Gd, Gd, Gll^Fdf, Gs, Gs, Gs, Gll^Fmf, Gs, Gg, Gll^Fmf, Gll^Fmf, Gll^Fmf, Gll^Fmf, Gs, Gs, Hh, Hh^Fmf, Gll^Fmf, Gs, Gs^Fms, Gs^Fms, Gg, Gs^Fms, Gs, Gg
Rb, Rb, Rb, Gll, Rb, Rb, Gll, Rb, Rb, Rb, Rb, Rb, Rb, Rb, Gll, Gll, Rb, Gll^Fdw, Gll, Gll^Fdw, Gll^Fdw, Gll, Gll, Gll^Fdf, Gd, Gs, Gs, Gs, Gs, Gs, Gll^Fmf, Gll^Fmf, Gll^Fmf, Gll^Fmf, Gs^Vhhr, Hh, Hh, Hh, Gll^Fmf, Gs^Fms, Gs, Gs^Fms, Gs, Gs, Gg, Gs
Rb, Rb, Rb, Cer, Cer, Gll, Rb, Gll^Feth, Gll^Fdw, Rb, Rb, Rb, Gd, Gd, Rb, Rb, Gll, Gll, Gll, Gll, Rb, Gll^Fdw, Gll^Fdw, Gll^Fdf, Gll^Fdw, Gll, Gll^Fdw, Gll^Fdf, Gs, Gg, Gll^Fmf, Gll^Fmf, Gd^Fdw, Gll^Fmf, Gll^Fmf, Hh, Hh, Hh^Fmf, Gs, Gg, Gs, Gg, Gs, Gg, Gg, Gg
Rb, Rb, Rb, Cer, Cer, Cer, Rb, Rb^Vhhr, Gll, Rb, Rb, Gll, Gll^Fdw, Gll^Fdw, Rb, Rb, Rb, Rb, Rb, Rb, Rb, Gll, Gll, Gll^Fdw, Gll, Gll^Fdw, Gll, Gll^Fdf, Gll^Fdf, Gll^Fdf, Gll^Fdf, Gd, Gs^Fdw, Gd, Gll^Fmf, Gll^Fmf, Gll^Fmf, Gg, Gs, Gs, Gs, Gs, Gs^Vl, Gg, Gg, Gg
Rb, Rb, Rb, 2 Ker, Rb, Rb, Rb, Gll, Rb, Rb, Rb, Rb, Rb, Gll, Rb, Rb, Rb, Rb, Rb, Rb, Rb, Rb, Rb, Gll, Gll, Gll, Gll, Gd^Vhr, Gs, Gll^Fdf, Gll^Fdf, Gs, Gs, Gs, Gs, Gll^Fmf, Gll^Fmf, Gg, Gg, Gg, Gs, Gs, Gg, Gg, Gg, Gg
Rb, Rb, Rb, Rb, Rb, Rb, Rb, Rb, Rb, Rb, Rb, Rb, Rb, Gll, Rb, Rb, Rb, Rb, Rb, Rb, Rb, Rb, Rb, Gll, Rb, Rb, Gg, Gll, Gs, Gg, Gg, Gg, Gs, Gs, Gg, Gs, Gg, Gs, Gg, Gg, Gg, Gg, Gg, Gg, Gg, Gg
