Ur^Ii, Ur^Ii, Ur^Ii, Gll^Ii, Gll^Ii, Gll^Ii, Gs^Ii, Gs^Ii, Gs^Ii, Uu^Ii, Uu^Ii, Xue, Xue, Xue, Xue, Xue, Xue, Xue, Xue, Tb^Tf, Tb^Tf, Uue, Uhe, Uhe, Uh, Uh, Uu, Uu, Uu, Tb^Tf, Tb^Tf, Xue, Xue, Xue, Xue, Xue, Xue, Xue, Xue, Xue, Xue, Xue, Xue, Xue, Xue, Xue
Gs^Ii, Ur^Ii, Ur^Ii, Ur^Ii, Ur^Ii, Gll^Ii, Ur^Ii, Gll^Ii, Xue, Uu^Ii, Xue, Xue, Xue, Xue, Xue, Xue, Xue, Xue, Xue, Tb^Tf, Tb^Tf, Uue, Uue, Uhe, Uhe, Uh, Uu, Uu, Uu^Vu, Tb^Tf, Uu, Uu, Uu, Xue, Xue, Xue, Xue, Xue, Xue, Xue, Xue, Xue, Xue, Xue, Xue, Xue
Gs^Ii, Gs^Ii, Ur^Ii, Ur^Ii, Ur^Ii, Ur^Ii, Ur^Ii, Uu^Ii, Xue, Xue, Xue, Xue, Uue, Uue, Uue, Xue, Xue, Xue, Xue, Tb^Tf, Uue, Uue, Uu, Uhe, Uu, Uu, Tb^Tf, Tb^Tf, Cfr, Uu, Uu, Uu, Uu, Uh, Xue, Xue, Xue, Xue, Xue, Xue, Xue, Xue, Xue, Xue, Xue, Xue
Gll^Ii, Gll^Ii, Ur^Ii, Ur^Ii, Ur^Ii, Ur^Ii, Ur^Ii, Ur^Ii, Xue, Xue, Tb^Tf, Uue, Uue, Uue, Uue, Uue, Xue, Xue, Xue, Tb, Uue, Uue, Tb^Tf, Uu, Uu, Uu, Tb^Tf, Cfr, 3 Kfr, Cfr, Uhe, Uue, Uue, Uh, Uh, Xue, Xue, Xue, Xue, Xue, Xue, Xue, Xue, Xue, Xue, Xue
Gll^Ii, Gll^Ii, Uu^Ii, Ur^Ii, Ur^Ii, Ur^Ii, Ur^Ii, Ur^Ii, Ur, Uue, Uue, Uue, Uue, Uue, Tb^Tf, Uue, Uue, Xue, Xue, Xue, Xue, Tb^Tf, Tb^Tf, Uu, Uu, Uu^Vu, Uue, Cfr, Cfr, Cfr, Uhe, Uhe, Uue, Uhe, Uhe, Xue, Xue, Xue, Xue, Xue, Xue, Xue, Xue, Xue, Xue, Xue
Uu^Ii, Uu^Ii, Uu^Ii, Uu^Ii, Xue, Ur^Ii, Ur, Ur^Ii, Ur, Ur, Ur, Ur, Ur, Uue, Uue, Tb^Tf, Tb^Tf, Xue, Xue, Xue, Xue, Tb^Tf, Tb, Uu, Uu, Uu, Uue, Uue, Uu^Vu, Uu, Uhe, Uhe, Uue, Uue, Uue, Uue, Uue, Xue, Xue, Xue, Xue, Xue, Xue, Xue, Xue, Xue
Uu^Ii, Uu^Ii, Uu^Ii, Uu^Ii, Xue, Xue, Ur, Ur, Ur, Ur, Ur, Ur, Ur^Ii, Ur, Ur, Uue, Uue, Xue, Xue, Xue, Xue, Xue, Uue, Uue, Uu, Uue, Uue, Uue, Uu, Uu, Uu, Uu^Vu, Uue, Uue, Uue, Uue, Tb, Xue, Xue, Xue, Xue, Xue, Xue, Xue, Xue, Xue
Xue, Xue, Xue, Xue, Xue, Xue, Uue, Ur, Uue, Ur, Ur, Ur, Ur^Ii, Ur^Ii, Ur^Ii, Ur, Uue, Uue, Xue, Xue, Xue, Xue, Xue, Uue, Uu, Uue, Uu, Uue, Uu, Uu, Uu, Uue, Uu, Uu, Uu, Uue, Tb^Tf, Tb^Tf, Xue, Xue, Xue, Xue, Xue, Xue, Xue, Xue
Xue, Xue, Xue, Xue, Uue, Uue, Uue, Uue, Uue, Ur, Uue, Uue^Ii, Ur^Ii, Ur^Ii, Ur^Ii, Ur, Ur, Uue, Uue, Tb^Tf, Uue, Xue, Uue, Uue, Ur, Uu, Tb^Tf, Uu, Uu, Uu, Uu^Ii, Uu, Uu, Uu, Uu, Uue, Uue, Tb^Tf, Xue, Xue, Xue, Xue, Xue, Xue, Xue, Xue
Xue, Xue, Xue, Xue, Xue, Uue, Uue, Uue, Uue, Uue, Uue, Uue, Uue, Uue, Uue, Ur, Ur, Ur, Ur, Ur, Ur, Uue, Ur, Ur, Ur, Ur, Ur, Uu^Ii, Ur^Ii, Uu^Ii, Uu^Ii, Uu, Uu, Uu, Uu, Tb^Tf, Tb^Tf, Xue, Xue, Xue, Xue, Xue, Xue, Xue, Xue, Xue
Xue, Xue, Xue, Xue, Xue, Uue, Tb^Tf, Tb^Tf, Uue, Uue, Tb^Tf, Uue, Uue, Uue, Uue, Uue, Uhe, Ur, Uue, Ur, Ur, Ur, Ur, Ur, Uu, Ur, Ur, Ur^Ii, Ur^Ii, Ur^Ii, Ur, Uu, Uu, Uu, Uu, Tb^Tf, Uu, Uue, Uue, Xue, Xue, Xue, Xue, Xue, Xue, Xue
Xue, Xue, Xue, Xue, Xue, Uue, Tb^Tf, Uue, Uhe, Uhe, Uhe, Uue, Uue, Uue, Uue, Uhe, Uhe, Uhe, Uhe, Uue, Uue, Uue, Uu, Uu, Uu, Uu, Uu, Uu^Vud, Uu^Ii, Tb^Tf, Ur^Ii, Ur^Ii, Ur, Uu, Uu, Uu, Uu, Uue, Uu, Uue, Xue, Xue, Xue, Xue, Xue, Xue
Xue, Xue, Xue, Xue, Xue, Xue, Xue, Xue, Tb^Tf, Uhe, Tb, Uhe, Uue, Uue, Uue, Uhe, Uue, Uue^Vu, Tb, Uhe, Xue, Xue, Xue, Uue, Qxu, Qxu^Ii, Qxu, Tb^Tf, Tb^Tf, Uu^Ii, Uu, Ur^Ii, Ur, Ur, Ur, Uu, Uu, Uu, Uu, Uu, Xue, Xue, Xue, Xue, Xue, Xue
Xue, Xue, Xue, Xue, Xue, Xue, Xue, Xue, Xue, Tb, Uue^Vu, Uhe, Uhe, Uue, Uue, Uue, Uue, Tb^Tf, Xue, Xue, Uue, Xue, Uu, Xue, Qxu, Qxu, Qxu^Ii, Qxu, Xue, Uue, Uue, Uu, Uu, Ur, Ur, Uu, Ur, Uu, Uue, Uue, Xue, Xue, Xue, Xue, Xue, Xue
Xue, Xue, Xue, Xue, Xue, Xue, Xue, Xue, Xue, Xue, Xue, Xue, Uue^Vu, Uue, Uue, Uue, Uue, Tb^Tf, Xue, Uue, Uu, Tb, Uu^Ii, Uu, Uu, Qxu, Uu, Uu, Tb, Xue, Tb^Tf, Tb^Tf, Uue, Uu, Ur, Ur, Ur, Uu, Tb^Tf, Xue, Xue, Xue, Xue, Xue, Xue, Xue
Xue, Xue, Xue, Xue, Xue, Xue, Xue, Xue, Xue, Xue, Xue, Xue, Cfr, Cfr, Cfr, Uue^Vu, Xue, Xue, Xue, Uue, Tb^Tfi, Uu^Ii, Uu^Ii, Uu^Ii, Uu, Uu, Uu, Uu, Uu, Xue, Xue, Tb^Tf, Uue, Uu, Uu, Ur, Ur, Uu, Tb^Tf, Xue, Xue, Xue, Xue, Xue, Xue, Xue
Xue, Xue, Xue, Xue, Xue, Xue, Xue, Xue, Xue, Xue, Xue, Xue, Cfr, Cfr, Cfr, Cfr, Xue, Xue, Uu, Tb^Tfi, Uu^Ii, Uu^Ii, Uu, Uu^Ii, Uu, Uu, Uu, Uu, Uu, Tb, Tb^Tf, Xue, Xue, Uu, Uu, Uu, Ur, Ur, Uu, Uue, Uue, Xue, Xue, Xue, Xue, Xue
Xue, Xue, Xue, Xue, Xue, Xue, Xue, Xue, Xue, Xue, Xue, Xue, Xue, 4 Kfr, Xue, Xue, Uue, Uu, Uu, Uu, Uu^Ii, Uu^Ii, Uu^Ii, Uu, Ur, Uu, Ur, Uu, Uu, Uu, Tb^Tf, Tb^Tf, Tb^Tf, Xue, Xue, Uu, Uu, Ur, Ur, Uu, Uu, Xue, Xue, Xue, Xue, Xue
Xue, Xue, Xue, Xue, Xue, Xue, Xue, Xue, Xue, Xue, Xue, Xue, Xue, Xue, Xue, Uue^Tf, Uue, Uu, Uu, Uu, Uu, Uu, Ur, Ur, Ur, Ur, Ur, Uu, Uu, Uu, Uu, Tb^Tf, Uu, Xue, Xue, Xue, Tb^Tf, Uue, Ur, Ur, Uu, Uue, Tb^Tf, Xue, Xue, Xue
Xue, Xue, Xue, Xue, Xue, Xue, Xue, Xue, Xue, Xue, Xue, Xue, Xue, Xue, Uue^Tf, Uue, Uu, Uu, Uu, Uu, Ur, Ur, Ur, Ur, Uu^Vud, Ur, Ur, Ur, Ur, Uu, Uu, Uu, Uu, Uu^Efs, Uu, Xue, Xue, Uue, Ur, Ur, Uu, Uue, Uue, Tb, Tb, Tb^Tf
Xue, Xue, Xue, Xue, Xue, Xue, Xue, Xue, Xue, Xue, Xue, Xue, Xue, Xue, Uu, Uu, Uu, Uu, Ur, Ur, Uu, Ur, Uu, Uu, Uu, Uu, Uu, Tb^Tf, Ur, Ur, Ur, Uu, Uu, Uu, Uu, Uu, Xue, Uue, Uu, Ur, Ur, Ur, Uu, Tb^Tf, Tb^Tf, Tb
Xue, Xue, Xue, Xue, Xue, Xue, Xue, Xue, Xue, Xue, Xue, Xue, Xue, Xue, Uu, Uu^Vud, Uue, Uu, Ur, Ur, Uu, Uu, Uu, Uu, Xue, Uu, Uu, Tb^Tf, Tb^Tf, Tb^Tf, Ur, Ur, Ur, Uu, Uu, Uu, Uu, Xue, Uu, Uu, Uu, Uu, Uu, Tb, Tb, Tb
Xue, Xue, Xue, Xue, Xue, Xue, Xue, Xue, Xue, Xue, Xue, Xue, Xue, Xue, Xue, Uue^Tf, Uu, Uu, Uu, Uu, Uu, Uu, Uu, Xue, Xue, Uu, Uue, Tb^Tf, Uu, Uu, Uu, Ur, Ur, Uu, Uu, Uu, Uu, Xue, Uu, Uu, Ur^Ii, Ur^Ii, Uu, Tb^Tf, Tb^Tf, Uue
Xue, Xue, Xue, Xue, Xue, Xue, Xue, Xue, Xue, Xue, Xue, Xue, Xue, Xue, Xue, Xue, Uue, Uu, Ur, Ur, Uu, Uu, Uu, Uue, Xue, Xue, Uue, Uu, Uu, Uu, Uu^Ii, Uu, Uu^Ii, Ur, Uu^Vud, Uu^Ii, Uu, Xue, Uu, Uu, Ur^Ii, Ur^Ii, Uu^Ii, Tb^Tfi, Tb^Tf, Uue
Xue, Xue, Xue, Xue, Xue, Xue, Xue, Xue, Xue, Xue, Xue, Xue, Xue, Xue, Xue, Xue, Uu, Uu, Ur, Ur, Uu, Uu, Uu, Uu, Uue, Xue, Xue, Uue, Uue, Uu, Uu, Uu^Ii, Uu^Ii, Uu^Ii, Uu^Ii, Uu^Ii, Uu, Xue, Uu, Uu^Ii, Ur, Ur^Ii, Uu^Vud, Uu^Ii, Uue, Uue
Xue, Xue, Xue, Xue, Xue, Xue, Xue, Xue, Xue, Xue, Xue, Xue, Xue, Xue, Xue, Xue^Efs, Uu, Uu, Uu, Uu, Uu, Uu, Uu, Uu, Uue, Uue, Uue, Xue, Uue, Uu, Xue, Uu, Uu^Ii, Ur^Ii, Ur^Ii, Uu^Ii, Uu, Uu, Uu, Uu, Ur, Ur, Uue, Uue, Uue, Uue
Xue, Xue, Xue, Xue, Xue, Xue, Xue, Xue, Xue, Xue, Xue, Xue, Xue, Xue, Xue, Xue, Uu, Uu, Uu^Ii, Ur, Uu^Vud, Uu, Uu, Uu, Uu, Uue, Uue, Xue, Xue, Xue, Uh^Tf, Uu, Uu, Ur^Ii, Ur^Ii, Ur^Ii, Ur, Ur, Ur, Ur, Ur, Uue, Uue, Wwg, Wwg, Wwg
Xue, Xue, Xue, Xue, Xue, Xue, Xue, Xue, Xue, Xue, Xue, Xue, Xue, Xue, Cud, Cud, Uu, Uu^Vud, Ur^Ii, Ur, Uu^Ii, Uu^Ii, Uu, Uu, Uu, Uue, Xue, Xue, Uh^Tf, Uh, Uh^Tf, Uh^Tf, Uu, Uu, Uu, Uu, Uu, Uu, Uue, Ur, Uue, Uue, Wwg, Wwg, Wwg, Wwg
Xue, Xue, Xue, Xue, Xue, Xue, Xue, Xue, Xue, Xue, Xue, Xue, Xue, Xue, 1 Kud, Cud, Ur, Ur^Ii, Ur^Ii, Ur^Ii, Uu, Uu, Xue, Xue, Xue, Xue, Uh, Uh, Uh, Uh^Tf, Uh^Tf, Uu, Uu, Uu, Uu, Uu, Xue, Uue, Wwg, Uue, Wwg, Uue, Wwg, Wwg, Wog, Wwg
Xue, Xue, Xue, Xue, Xue, Xue, Xue, Xue, Xue, Xue, Xue, Xue, Xue, Xue, Cud, Cud, Uu, Ur^Ii, Ur^Ii, Uu^Ii, Uu, Xue, Xue, Uh^Tf, Uh^Emf, Uh^Emf, Uh, Uh, Uu, Uu, Uu, Uu, Uu, Uu, Uh^Vu, Uh^Tf, Xue, Xue, Wwg, Wwg, Wwg, Wwg, Wwg, Wwg, Wog, Wog
Xue, Xue, Xue, Xue, Xue, Xue, Xue, Xue, Xue, Xue, Xue, Xue, Xue, Xue, Xue, Cud, Uu^Vud, Uu, Ur, Uu, Xue, Xue, Uh^Emf, Uh^Tf, Uh, Uh, Uh, Uh, Uu, Uu, Uu, Uu, Uu, Uh^Tf, Uh^Tf, Uh^Tf, Xue, Wwg, Wwg, Wwg, Wog, Wwg, Wog, Wog, Wog, Wog
Xue, Xue, Xue, Xue, Xue, Xue, Xue, Xue, Xue, Xue, Xue, Xue, Xue, Xue, Xue, Xue, Uue^Tf, Ur, Ur, Uu, Xue, Xue, Uh^Emf, Uh^Emf, Uh, Uh, Uh, Uh^Vu, Cfr, Uu, Uu, Uu, Uh^Emf, Uh, Uh^Emf, Uh^Tf, Xue, Wwg, Wog, Wog, Wog, Wog, Wog, Wog, Wog, Wog
Xue, Xue, Xue, Xue, Xue, Xue, Xue, Xue, Xue, Xue, Xue, Xue, Xue, Xue, Xue, Xue, Uue^Tf, Uue, Ur, Uu^Vud, Xue, Uh, Uh, Uh^Emf, Uh, Uh, Uh^Vu, Cfr, Cfr, Cfr, Cfr, Uh^Vu, Uh, Uh, Uh^Emf, Uh^Tf, Uh^Tf, Xue, Xue, Wog, Wog, Wog, Wog, Wog, Wog, Wog
Xue, Xue, Xue, Xue, Xue, Xue, Xue, Xue, Xue, Xue, Xue, Xue, Xue, Xue, Xue, Xue, Uu, Ur, Uue, Ur, Xue, Xue, Uh, Uh, Uh, Uh, Uh, 2 Kfr, Cfr, Cfr, Cfr, Uh, Uh, Uh, Uh, Uh^Tf, Uh^Tf, Uh, Xue, Wog, Wog, Wog, Wog, Wog, Wog, Wog
Xue, Xue, Xue, Xue, Xue, Xue, Xue, Xue, Xue, Xue, Xue, Xue, Xue, Xue, Xue, Xue, Uu, Ur, Uue, Uue^Tf, Xue, Xue, Xue, Uh, Uh, Uh, Uh, Uh, Uh, Uh, Uh, Uh, Uh, Uh, Uh, Uh, Uh, Xue, Xue, Xue, Wog, Wog, Wog, Wog, Wog, Wog
