Gg, Gg, Gg, Gg, Gg^Es, Gg, Gg^Es, Gg, Gg^Fds, Gg^Fds, Gg^Fp, Gg^Fp, Gg^Fds, Gg, Gg^Fds, Gg^Fms, Gg^Fds, Gg^Efm, Ww, Ww, Ww, Ww, Ww, Ww, Ww^Ewf, Ww, Gg^Fds, Gg, Gg, Gg, Gg^Fds, Gg, Gg^Fds, Gg, Gg^Fds, Gg, Gg^Fds, Gg, Gg^Fds, Gg, Gg, Gg
Gg, Gg, 3 Ker, Gg^Es, Gg^Es, Gg^Es, Gg^Es, Gg^Es, Gg^Fds, Gg^Fp, Gg^Fms, Gg^Fds, Gg^Fds, Gg^Fds, Gg^Fms, Gg^Fds, Gg^Fds, Gg^Fds, Gg^Efm, Ww, Ww, Ww, Wo, Ww^Ewl, Wo, Ww^Ewf, Gg, Gg, Gg^Efm, Gg, Gg, Gg^Fds, Gg^Fds, Gg^Fds, Gg^Fds, Gg^Fds, Gg^Fds, Gg^Fds, Gg, Gg^Efm, Gg, Gg
Gg, Gg, Cer, Cer, Cer, Gg^Es, Gg^Es, Gg^Es, Gg, Gg^Fds, Gg^Fms, Gg^Fms, Gg^Fms, Gg^Fds, Gg^Efm, Gg^Efm, Gg^Fds, Gg^Fds, Gg^Fp, Ww, Ww^Ewf, Wo, Wo, Wo, Wo, Ww, Ww, Gg, Gg, Gg^Efm, Gg, Gg, Gg, Gg^Fds, Gg^Efm, Gg^Efm, Gg, Gg, Gg, Gg, Rr, Rr
Gg, Gg^Vc, Gg^Es, Cer, Gg, Gg^Vc, Gg, Gg^Es, Gg, Gg^Fds, Gg^Fds, Gg^Fds, Gg^Fds, Gg^Fds, Gg^Fds, Gg^Fms, Gg^Fp, Gg^Fp, Gg^Fds, Gg^Fds, Ww^Ewl, Ww^Ewl, Ww, Wo, Wo, Wo, Ww^Ewl, Gg^Fds, Gg^Fds, Gg, Gg, Gg, Rr, Gg, Gg, Gg, Gg, Gg, Rr, Rr, Gg, Gg
Gg, Gg, Gg, Gg^Es, Gg, Gg, Gg, Gg, Gg, Gg^Fds, Gg^Fds, Gg^Fds, Gg^Fds, Gg^Efm, Gg^Fms, Gg^Fds, Gg^Fds, Gg^Fms, Gg^Fds, Gg^Fds, Gg^Efm, Ww, Ww, Wo, Wo, Ww^Ewf, Ww^Ewf, Gg^Fds, Gg^Fds, Gg^Vhc, Rr, Rr, Gg, Rr, Rr, Gg^Efm, Rr, Rr, Gg^Efm, Gg, Gg, Gg
Gg, Gg, Gg^Es, Gg, Gg^Vl, Gg, Gg, Gg^Es, Gg^Fds, Gg^Fds, Gg^Fms, Gg^Fds, Gg^Fds, Gg^Fds, Gg^Fms, Gg^Fds, Gg^Fds, Gg^Fms, Gg^Fds, Gg^Fms, Gg^Fds, Ww, Ww, Wo, Wo, Wo, Ww, Gg^Fds, Rr, Rr, Gg^Vhc, Gg, Gg^Fds, Gg, Gg, Rr, Rr, Rr, Rr, Gg, Gg, Gg
Gg^Fms, Gg, Gg, Gg, Gg, Gg, Gg^Es, Gg, Gg^Fds, Gg^Fds, Gg^Fds, Gg^Efm, Gg^Fp, Gg^Fds, Gg^Fds, Gg^Fds, Gg^Fds, Gg^Efm, Gg^Fds, Gg^Ve, Gg^Fds, Gg^Fds, Gg^Fds, Ww, Ww, Wo, Wo^Bw/, Ww^Bw/, Gg^Efm, Gg, Gg^Fds, Gg^Efm, Gg^Fds, Gg^Fds, Gg^Fds, Gg, Gg, Gg, Rr, Gg, Gg, Gg
Gg^Fms, Gg^Fds, Gg^Fds, Gg, Gg^Fds, Gg, Gg^Fds, Gg^Fds, Gg^Fds, Gg^Fds, Gg^Fp, Gg^Fds, Gg^Fds, Gg^Fds, Gg^Fp, Gg^Fds, Gg^Fds, Gg^Fms, Gg^Fds, Gg^Fds, Gg^Fp, Gg^Fds, Gg^Fds, Ww, Ww^Bw/, Wo^Bw/, Wo, Ww, Ww, Gg, Gg^Fds, Gg^Fds, Gg^Fds, Gg^Fms, Gg^Fms, Gg^Fds, Gg^Efm, Gg, Rr, Gg, Gg, Gg
Gg^Fms, Gs^Fds, Gs^Fms, Gs^Fds, Gs^Fds, Gg^Fds, Gs^Fds, Gg^Fms, Gg, Gg^Fms, Gg^Fms, Gg^Fds, Gg^Fp, Gg^Fds, Gg^Fds, Gg^Fds, Gg^Fds, Gg^Fds, Gg^Fp, Gg^Fp, Gg^Fms, Gg^Fds, Gg^Fds, Rr, Ww, Ww, Wo, Ww, Ww^Ewf, Gg^Fds, Gg^Fms, Gg^Fms, Gg^Fp, Gg^Fp, Gg^Fds, Gg^Fds, Gg^Fp, Gg, Rr, Gg, Gg, Gg
Gg, Gg, Gg, Gg^Fds, Gg, Gg^Fds, Gg, Gs^Fds, Gs^Fmf, Gg, Gg, Gg^Fms, Gg^Fds, Gg^Fds, Gg^Ve, 1 Kvr^Fds, Cv^Fds, Cv^Fp, Gg^Ve, Gg^Fds, Gg^Fds, Gg^Fms, Gg^Fds, Gg^Fds, Gg^Fds, Ww, Ww, Ww, Ww, Gg^Fds, Gg^Fds, Gg^Fds, Gg^Fms, Gg^Fms, Gg^Fp, Gg^Fds, Gg^Fds, Gg^Fds, Rr, Gg, Gg, Gg
Gg, Gg, Gs, Gg, Gg^Fmf, Gs, Gg^Fmf, Gs^Fmf, Gs^Fmf, Gs^Fmf, Gs, Gg, Gg, Gg^Fds, Gg^Fds, Cvr^Fms, Cvr^Fp, Cv^Fms, Gg^Fds, Gg^Fds, Gg^Fds, Gg^Fms, Gg^Ve, Gg^Fds, Gg^Fds, Ww, Wwf, Wwf, Wwf, Gg^Fds, Gg^Efm, Gg^Fds, Gg^Fds, Gg^Fds, Gg^Fp, Gg^Fms, Gg^Fds, Gg^Fds, Rr, Gg^Efm, Gg, Gg
Gg, Gs, Gg, Gs, Gs^Fmf, Gg^Fmf, Gs^Fmf, Gs, Gg, Gg, Gg, Gs, Gg, Gg^Fds, Gg, Gg^Fds, Gg^Fms, Gg^Fds, Gg^Fds, Gg^Efm, Gg^Fds, Gg^Fds, Gg^Fms, Gg^Fms, Gg^Fp, Gg^Fds, Gg^Fds, Wwf, Wwf, Gg, Gg, Gg, Gg^Fds, Gg^Fds, Gg^Fds, Gg^Fds, Gg^Es, Gg, Gg^Vhc, Rr, Gg, Gg
Gll, Gd^Fmf, Gd, Gg^Fmf, Gs, Gg^Fmf, Gg^Fmf, Gs, Gg, Gg, Gs, Gs, Gs^Fmf, Gs^Fmf, Gg, Gg, Gg, Gg^Fds, Gg^Fds, Gg^Efm, Gg^Fds, Gg^Fds, Gs^Fds, Gg^Fms, Gg^Fms, Gg^Fms, Gg^Fds, Wwf, Wwf, Wwf, Ww, Gg, Gg^Wm, Gg, Gg, Gg, Gg, Gg, Rr, Rr, Gg^Efm, Gg
Gll, Gd^Fmf, Gd^Fmf, Gs, Gs, Gs, Gd^Fmf, Gg^Fmf, Gs, Gs, Gg, Gs, Gg, Gg^Fmf, Gs^Fmf, Gg, Gg, Gg^Fds, Gg^Fmf, Gg^Fds, Gs, Gs, Gs, Gg^Fds, Gg^Fds, Gg^Fds, Gg^Fp, Wwf, Ww, Ww, Ww^Ewl, Gg, Gg, Gg^Vhc, Rr, Rr, Rr, Rr, Gg^Efm, Gg, Gg^Wm, Gg
Gll, Gll^Fmf, Gll^Fmf, Gd, Gd, Gd, Gd^Fmf, Gd^Fdw, Gd, Gd, Gd^Fdw, Gd, Gg, Gg, Gg, Gs, Gs, Gg, Gs^Fmf, Gs^Fmf, Gg, Gs, Gs^Fds, Gg^Fds, Gg^Fp, Gg^Fp, Gg^Fms, Gg^Fds, Ww, Ww^Ewf, Ww, Gg, Ch, Gg^Es, Rr, Ch, Ch, Rr, Rr, Gg^Vhc, Gg, Gg
Gll, Gll^Fmf, Gll, Gll^Fdw, Gll, Gll, Gll^Fmf, Gd^Fmf, Gll, Gd, Gll^Fdw, Gd, Gll, Gd, Gg, Gg, Gs, Gs^Fmf, Gs, Gg, Gg^Fmf, Gs, Gs, Gs^Fds, Gg^Fds, Gg^Fds, Gg^Fds, Gg^Fds, Ww^Ewf, Ww, Ww, Ww, Rr, Rr, Rr, Ch, Ch, 4 Kh, Rr, Gg^Es, Gg, Gg
Gll, Gll^Fmf, Gll, Gll, Gd^Fdf, Gd^Fmf, Gll^Fdw, Gll^Fmf, Gll, Gll, Rb, Rb, Gll^Fdw, Gll, Gd, Gs, Gg^Fmf, Gg^Fmf, Gs^Fmf, Gg, Gg, Gg^Fmf, Gg, Gs, Gg^Fms, Gg^Fds, Gg^Fds, Gg^Fds, Ww, Ww, Wo^Bsb/, Ww^Bsb/, Ww, Ch, Gg^Vhc, Rr, Rr, Rr, Gg, Gg^Efm, Gg^Fds, Gg
Rb, Rb, Rb, Gll, Gll, Gll^Fdf, Gll, Gll^Fdf, Gll, Rb, Rb^Vhcr, Rb^Fdw, Rb, Gll, Gd^Fmf, Gd^Fmf, Gg^Fmf, Gs, Gs, Gg, Gg, Gg^Fmf, Gg^Fmf, Gg, Gg^Fds, Gg^Fds, Gs^Fds, Rr, Rr, Ww^Bsb/, Wo, Wo, Wo, Ww, Ww^Ewf, Gg, Gg, Gg, Gg^Efm, Gg^Fds, Gg^Fds, Gg^Fds
Rb, Rb, Rb, Rb, Rb, Gll^Fdf, Rb, Gll^Fdw, Rb, Rb, Rb, Rb, Rb, Gll, Gd^Fdf, Gd, Gd^Fmf, Gs^Fmf, Gg^Fmf, Gg^Fdw, Gd^Fmf, Gg^Fmf, Gg, Gg^Fds, Gg, Gg^Fds, Rp, Rr, Rr, Ww, Ww, Wo, Wo, Ww, Ww, Gg^Es, Gg, Gg^Efm, Gg, Gg^Fds, Gg^Fds, Gg^Fds
Rb, Rb, Gll^Fdw, Rb^Fdw, Rb^Vhcr, Rb, Rb, Rb, Rb, Rb, Rb, Rb^Fdw, Rb, Gll, Gll^Fdw, Gd^Fdf, Gd, Gs, Gs^Fmf, Gd, Gd, Gd, Gd, Gg, Rp, Rp, Gg^Fds, Gs^Fms, Gg^Fds, Gg, Ww, Ww, Ww^Ewl, Wo, Wo, Ww, Ww, Gg, Gg, Gg^Fds, Gg^Fds, Gg^Fds
Rb, Gll^Fdf, Gll, Rb^Fdw, Rb^Edb, Rb, Rb, Rb, Rb^Fdw, Rb, Rb, Rb, Rb, Gll, Rb, Gll, Rb, Gll^Fdw, Gd^Fdf, Gd^Fdf, Gd, Gd, Gg, Gd, Gg, Gd, Gg^Fds, Gs, Gs^Fds, Gg, Gg, Ww^Ewf, Ww^Ewl, Wo, Wo, Wo, Wo, Ww, Ww, Gg, Ww, Gg
Rb, Gll, Gll, Rb^Edb, Rb^Edb, Rb^Edb, Rb, Rb, Rb^Fdw, Rb^Fdw, Rb, Rb, Rb, Rb, Rb, Rb, Rb^Vhcr, Gll, Gll, Gd^Fdf, Gd, Gd, Gd^Fmf, Gg^Fmf, Gs^Fmf, Gg^Fmf, Gg^Fds, Gs^Fds, Gg^Fms, Gg^Fds, Gg^Fds, Gg^Fds, Ww^Ewl, Ww, Ww, Wo, Wo, Wo, Ww^Ewl, Ww^Ewf, Ww, Ww
Rb, Gll, Cer, Cer, Cer, Rb, Gll^Edb, Rb^Edb, Rb^Edb, Rb^Fdw, Rb^Fdw, Rb, Rb, Rb, Rb, Rb, Rb, Gll, Gll, Gd, Gd, Gd, Gd, Gg, Gs, Gg, Gg, Gs^Fds, Gg^Fds, Gg^Fms, Gg^Fms, Gg, Gg, Ww, Ww, Ww, Wo, Wo, Wo, Wo, Wo, Ww
Rb^Edb, Rb^Edb, Rb^Edb, Cer, Cer, Cer, Gll^Edb, Rb^Edb, Rb^Edb, Rb^Vhcr, Gll^Fdw, Gll^Fdw, Gll^Fdf, Rb, Rb, Rb, Rb^Fdw, Rb, Rb, Gll, Gll, Gd, Gd^Fmf, Gg^Fmf, Gs^Fmf, Gs, Gs, Gs, Gs^Fds, Gg, Gg^Fms, Gg^Fds, Gg^Fds, Gg, Gg, Ww, Ww, Wo, Wo, Wo, Wo, Wo
Rb, Rb^Edb, Rb^Edb, 2 Ker, Rb, Cer, Rb^Edb, Rb^Edb, Rb^Edb, Rb^Edb, Rb^Edb, Gll, Gll, Gll^Fdf, Rb, Rb, Rb, Rb^Fdw, Rb, Gll, Gd, Gd^Fmf, Gs^Fmf, Gg^Fmf, Gs, Gs^Fmf, Gg^Fmf, Gg^Fmf, Gs, Gs^Fds, Gs^Fds, Gg^Fds, Gg^Fms, Gg^Fds, Gg^Fds, Gg, Gg, Ww, Ww, Wo, Ww, Wo
Gg, Rb^Edb, Rb, Rb, Rb, Rb, Rb, Rb^Edb, Rb, Rb^Edb, Rb, Rb, Rb, Rb, Rb, Rb, Rb, Rb, Rb, Gll, Gg, Gd, Gg, Gs, Gg, Gg, Gg, Gg, Gg, Gg^Fds, Gg^Fms, Gg^Fds, Gg, Gg^Fms, Gg, Gg^Fds, Gg, Gg, Ww, Ww, Ww, Ww
