Mm, Mm, Mm, Mm, Mm, Mm, Mm, Ur, Ur, Ur, Ur, Ur, Ur, Ur, Ur, Ur, Mm, Mm, Mm, Mm, Mm, Mm
Mm, Mm, Mm, Mm, Mm, Mm, Mm, Ur^Vud, Ur, Ur, Ur, Ur, Ur, Ur, Ur, Ur^Vud, Mm, Mm, Mm, Mm, Mm, Mm
Mm, Mm, Mm, Mm, Mm, Mm, Mm, Mm, Mm, Ur^Vud, Urb, Ur, Urb, Ur^Vud, Mm, Mm, Mm, Mm, Mm, Mm, Mm, Mm
Mm, Mm, Hh, Mm, Mm, Mm, Hh, Hh, Hh^Vud, Mm, Urb, Urb, Urb, Urb, 4 Kf, Mm, Mm, Mm, Mm, Mm, Mm, Mm
Hh, Hh, Mm, Hh, Hh, Hh, Hh, Hh, Cf, Cf, Urb, Urb, Urb, Urb, Cf, Cf, Hh^Vud, Hh, Mm, Mm, Mm, Mm
Hh, Hh, Mm, Mm, Hh, Hh, Hh, Hh, Cf, Cf, Urb, Urb, Urb, Urb, Cf, Cf, Hh, Hh, Mm, Mm, Mm, Mm
Hh, Hh, Mm, Mm, Mm, Mm, Cf, Hh, Hh^Vud, Cf, Urb, Urb, Urb, Urb, Hh, Hh^Vud, Hh, Cf, Mm, Mm, Mm, Mm
Hh, Mm, Mm, Mm, Mm, Mm, Hh, Hh, Hh, Hh, Urb, Urb, Urb, Urb, Cf, Hh, Mm, Mm, Mm, Mm, Mm, Mm
Mm, Hh, Mm, Hh, Hh, Hh, Hh, Hh, Gg, Cf, Urb, Urb, Urb, Urb, Urb, Hh, Hh, Mm, Hh, Hh, Hh, Mm
Mm, Mm, Mm, Mm, Hh, Hh, Mm, Hh, Gg, Gg, Gg, Urb, Urb, Urb, Urb, Hh, Hh, Mm, Gs, Hh, Mm, Mm
Hh, Mm, Mm, Mm, Hh, Hh, Mm, Hh, Hh, Hh, Gg, Urb, Urb, Urb, Urb, Urb, Urb, Gg, Gs, Mm, Hh, Hh
Hh, Hh, Hh, Hh, Hh, Hh, Hh, Mm, Hh, Hh, Hh, Hh, Hh, Urb, Urb, Urb, Urb, Gg, Gd, Hh, Hh, Mm
Hh, Hh^Fms, Hh^Fms, Hh, Hh, Hh^Fms, Gg, Hh, Hh, Hh, Hh, Hh, Hh, Hh, Urb, Urb, Urb, Gg, Hhd, Hhd, Hh^Fms, Hh
Hh, Hh, Hh, Gg^Fms, Hh, Gg, Gg^Vh, Gg, Hh^Fms, Hh, Hh, Hh, Hh, Hh, Urb, Urb, Urb, Hhd, Hhd, Hhd, Hhd^Fms, Hh
Hh, Hh, Hh, Gg, Hh, Gg, Gg, Gg, Gg, Hh, Hh, Hh, Urb, Urb, Urb, Urb, Gs, Gd, Hhd^Fmf, Gd, Hhd^Fmf, Hhd
Hh, Hh, Hh^Fms, Hh^Fms, Hh^Fms, Hh^Fms, Gg, Gg, Gg, Gg, Urb, Urb, Urb, Urb, Gd, Hhd, Hhd^Fmf, Gd^Vhr, Hhd, Hhd^Fdw, Hhd^Fmf, Hhd^Fmf
Hh^Fms, Hh, Gg^Fms, Hh, Gg^Fms, Hh^Fms, Gg, Gg, Urb, Urb, Urb, Urb, Gll, Gd, Hhd^Fdw, Hhd^Fdw, Rb, Hhd, Hhd, Hhd, Gll^Vhr, Gll^Fmf
Hh, Hh^Fms, Gg, Gg, Hh^Fms, Hh, Gg, Urb, Urb, Urb, Cer, Rb, Hhd, Hhd, Gll^Fdw, Rb, Rb, Hhd, Hhd, Hhd^Fdw, Rb^Fdw, Rb
Hh^Fms, Hh, Hh, Hh^Fms, Hh^Fms, Hh, Gg, Urb, Urb, Cer, 3 Ker, Cer, Hhd, Hhd, Rb, Rb^Fdw, Rb, Hhd, Gll, Rb^Fdw, Rb, Rb
Gg^Fms, Hh^Fms, Gg^Fms, Hh^Fms, Hh, Gg^Vh, Gg, Urb, Urb, Cer, Cer, Cer, Rb, Hhd, Hhd, Rb^Vhr, Hhd, Hhd, Hhd, Rb, Gd^Fmf, Gll
Gg, Gg^Fms, Gg^Fms, Hh, Hh^Fms, Hh, Hh, Urb, Urb, Urb, Urb, Rb, Gll, Rb, Hhd^Fdw, Gll^Fdw, Hhd^Fmf, Hhd, Gll, Hhd^Fdw, Hhd^Fmf, Hhd
Gg, Gg^Fms, Gs^Fms, Hh^Fms, Hh^Fms, Hh^Fms, Hh, Gg, Gg, Urb, Urb, Urb, Gd, Gll, Gd, Hhd^Fmf, Hhd^Fmf, Hhd^Fmf, Hhd^Fdw, Hhd^Fdw, Hhd^Fmf, Gd
Gg, Gg^Fms, Gg^Fms, Hh^Fms, Gs^Fms, Gs^Fms, Gg, Gg, Gg, Gg, Urb, Urb, Gd, Gll, Gd, Gd^Fmf, Gs^Fmf, Gd^Fmf, Gs, Hhd, Hhd, Hhd^Fmf
Gs, Hh, Gs^Fmf, Gg^Fms, Gg^Fms, Gg^Fms, Gg, Gd, Gs, Gs, Urb, Urb, Gg, Gs, Gs^Fms, Gs, Gs^Fms, Gs^Fms, Gs, Gs, Hh^Fms, Gs
Gd, Gs, Gs, Gs^Fmf, Gs^Fmf, Gs^Fmf, Gs^Fmf, Gs, Gs, Gs, Urb, Urb, Gg^Vh, Gs, Gs^Fms, Gs, Hh^Fms, Hh^Fms, Hh^Fms, Gs^Fms, Hh^Fms, Hh
Gd, Gd, Gd^Fmf, Gd, Gd^Fmf, Gs, Gs, Gs^Fmf, Gs, Gs, Urb, Urb, Gg, Gg, Gg^Fms, Gg^Fms, Hh^Fms, Hh, Hh, Hh^Fms, Hh^Fms, Hh^Fms
Gd, Gd^Fmf, Gd^Fmf, Gd^Fmf, Gd^Fmf, Gd, Gd, Gd^Fmf, Gd^Fmf, Gd, Urb, Urb, Gg, Gg, Gs^Fms, Hh^Fms, Gg^Fms, Gg^Fms, Gs, Hh, Hh^Fms, Hh^Fms
Gll, Gll, Gll, Gd^Fmf, Gll^Fmf, Gd^Fdw, Gll^Fdw, Gd^Fmf, Gd^Fmf, Gd^Fmf, Urb, Urb, Urb, Gg, Gg, Gg^Fms, Gg, Gg^Fms, Gg^Fms, Hh^Fms, Hh^Fms, Hh^Fms
Gll, Gll, Gd, Gd^Fdw, Gll, Gll, Gd, Gll^Vhr, Gll, Gll, Gll, Urb, Urb, Urb, Urb, Gg, Gg, Gg^Fms, Gg^Fms, Gg^Fms, Gg^Fms, Gs^Fms
Rb, Rb, Rb, Rb^Fdw, Rb^Fdw, Gll, Rb, Gll, Rb, Gll, Cer, Cer, Cer, Urb, Urb, Gg, Gg, Gg, Gg^Fms, Gg^Fms, Gg^Fms, Gs^Fms
Rb, Rb^Fdw, Rb, Gll, Rb, Rb, Rb^Fdw, Rb, Rb, Rb, Cer, 2 Ker, Cer, Urb, Urb, Gg, Gg^Fms, Gg, Gg, Gg^Fms, Gg^Fms, Gs^Fms
Rb, Rb, Gd, Gll, Gll^Fdw, Gll, Gll, Rb, Gd, Rb, Rb, Cer, Urb, Urb, Urb, Gg, Gg^Fms, Gg, Gg^Fms, Gg^Fms, Gg^Fms, Gs^Fms
Gll, Gll, Gll, Gd^Vhr, Gd^Fmf, Gll^Fmf, Gll^Fdw, Gll^Fdw, Gll^Vhr, Gll, Gd^Fmf, Urb, Urb, Urb, Gg, Gg, Gg, Gg, Gg^Fms, Gg^Fms, Gg^Fms, Gg^Fms
Gll, Gll^Fmf, Gd^Fmf, Gd^Fmf, Gd^Fmf, Gd, Gd, Gd, Gd^Fmf, Gd^Fmf, Urb, Urb, Urb, Urb, Gg, Gg, Gg^Fms, Gg, Gg^Fms, Gg^Fms, Gg, Gg
Gd, Gd, Gd^Fmf, Gd, Gd^Fmf, Gd, Gd, Gd^Fmf, Gd^Fmf, Gd^Fmf, Urb, Urb, Urb, Gg, Gg, Gg, Gg^Fms, Gg, Gg, Gg^Fms, Gg^Fms, Gg
Gd, Gd, Gs, Gd^Fmf, Gs^Fmf, Gs, Gs^Fms, Gs, Gs^Fms, Gd^Fms, Urb, Urb, Gg, Gg, Gg^Fms, Gg^Fms, Gg, Gg, Gg, Gg, Gg, Gg^Fms
Gg, Gs, Gs^Fmf, Gs^Fmf, Gs^Fms, Gs^Fms, Gs^Fms, Gs^Fms, Gg, Gs, Urb, Urb, Gg^Fms, Gg^Fms, Gg^Fms, Gg^Vh, Gg, Gg, Gg, Gg, Gg, Gg
Gs, Gs^Fms, Gd^Fms, Gs^Fms, Gg^Fms, Gg, Gg, Gg, Gg, Gg, Urb, Urb, Gg, Gg^Fms, Gg, Gg, Gg, Gg, Gg, Gg, Gg, Gg
Gg, Gs^Fms, Gg^Fms, Gg^Fms, Gg, Gg, Gg, Gg^Fms, Gg, Gg, Urb, Urb, Gg, Gg, Gg, Gg, Gg, 1 Gg, Gg, Gg, Gg, Gg
Gg^Fms, Gg^Fms, Gg^Fms, Gg^Fms, Gg, Gs^Fms, Gs, Gg, Gg, Gg^Vh, Urb, Urb, Gg, Gg, Gg, Gg^Vh, Gg, Gg, Gg, Gg, Gg, Gg
Gg^Fms, Gs^Fms, Gg^Fms, Gs^Fms, Gs^Fms, Gs^Fms, Gg^Fms, Gs^Fms, Gg, Gg, Urb, Urb, Gg, Gg, Gg^Fms, Gg^Fms, Gg^Fms, Gg, Gg, Gg, Gg^Fms, Gg^Fms
Gg, Gg^Fms, Gg, Gg^Fms, Gg^Fms, Gs, Gg, Gs, Gg, Gg, Urb, Urb, Gg, Gg, Gg, Gg^Fms, Gg, Gg, Gg, Gg, Gg, Gg^Fms
